{
    "1": 0,
    "2": 150,
    "3": 300,
    "4": 500,
    "5": 800,
    "6": 1300,
    "7": 1600
}
